XXXXXooXXXXX
X..........X
X..........X
X..........X
X..........X
X..........X
X..........X
XXXXXXXoXXXX
