XXXXXXXXXXXXXXXX
X..............X
X..............X
X..............X
X..............o
X..............o
X..............X
X..............X
X..............X
XXXXXXXXXXXXXXXX
