   XXXXXX
  XX....XX
 XX......XX
XX........XX
X..........X
X..........o
X..........o
X..........X
XX........XX
 XX......XX
  XX....XX
   XXXXXX
