XXXooXX
X.....X
X.....X
X.....X
X.....X
X.....X
XXXXXXX