XXXXXXXXXXXXooXXX
X...............X
X...............X
X...............XXXXX
o...................o
o...................o
X...............XXXXX
X...............X
XXXXXX......XXXXX
     X......X
     X......X
     X......XX
     X.......XXXXX
     XX..........o
      XXX........o
        XXXXXXXXXX
