XXXXooXXXX
X........X
X........o
X........o
X........X
XXXXXXXXXX
