XXXooXXX
X......X
X......X
o......o
o......o
X......X
X......X
XXXooXXX