XXXXXXX...XXXXXXX
X...............X
X...............X
X...............XXXXX
X....................
X...............XXXXX
X...............X
XXXXXX......XXXXX
     X......X
     X......X
     X......X
     X......XX
     X.......XXXXX
     XX...........
      XX..........
       XXXXXXXXXXX